########E#######
#..........#...#
#.######.###.#.#
#.##...#..##.#.#
#....#..##.....#
##.#.########S##
##.#...........#
################
